R  500 1100

F  255,255,255
SO ./textures////south.xpm 
WE ./textures////west.xpm
EA ./textures/east.xpm
NO ./textures/north.xpm
S  ./sprites/7amda.xpm

C  255,132,100

 1111111111111111111111111111111111111
1001001000000000000000000000000000001
 1111100111110000111111111111100000001
    1000111000000111111111111100000001
    10001110000001            100000001
    10001110000001            10000000111111111111111111
    10001110000001      1     100000000000000000000000001
    10001110000001     121     100000000000000000000000001
    10001110000001      1     100000001111111111111111111
    10001110000001            100000001
    10001110000001            10000000111111111111111
    1000000000001111111111111100000000000000000000001
    1000002000000000000000000000000000000000000000001
1111000000N000000000000200000020000002000020000002001
11110000000000000200000000002000000020000200000020001                  
11111111111111111111111111111111111111111111111111111          11111111111111        
                                                               100000021    1       
                                                               100000001    1     
                                                               11111111111111   
 1111111111
   100000001
    100000001
    1111111111