R 1500 1500
SO ./textures/south.xpm
WE ./textures/west.xpm
EA ./textures/east.xpm
NO ./textures/north.xpm
S  ./sprites/7amda.xpm
F  112,255,30
C  255,132,10

11111111111111                   11111111111111111111111111111
10000000000001                   100000000000002000000000000001
10000000000001                  12000000000000000000000000000021
11111100201111                   100000000000002000000000000001
11111110001111                  100001111111110000000111111111111
11111110001111                  100001111111110000000111111111111
11111110N01111111111111111111111000001       100000001
11111110201000000000000000000000000001       1000000001          1 
11111110000000000000000000000000000001       1000000011111111111121111111111111
11111110001111111111111111111111111111        1000000000000000000000000000000001
11111111111111111111111111                   100000000000000000000000000000000021
                                              1111111111111111111211111111111111
                                                                 1
1111111111
